10,10,10,10,10,10,10,10,10,10
10,20,20,20,20,20,20,20,20,10
10,20,50,50,50,50,50,50,20,10
10,20,50,100,100,100,100,50,20,10
10,20,50,100,1000,800,100,50,20,10
10,20,50,100,600,1200,100,50,20,10
10,20,50,100,100,100,100,50,20,10
10,20,50,50,50,50,50,50,20,10
10,20,20,20,20,20,20,20,20,10
10,10,10,10,10,10,10,10,10,10